11111111111111111111111111111111111111111111111
1E0000000000000C00000C0000000000000000000000001
10100101001000001010010000000101000000000000001
10100100101010100010010000000101000000000000001
10100100101010100010010000000101000000000000001
10100100101010100010010000000101000000000000001
10100100101010100010010000000101000000000000001
10100100101010100010010000000101000000000000001
10100100101010100010010000000101000000000000001
10100100101010100010011000000101000000000000001
10100100101010100010011100000101000000000000001
10100100101010100010010000000101000000000000001
10100100101010100010010000000101000000000000001
10100100101010100010010100000101000000000000001
10100100101010100010010000000101000000000000001
101001001010101000100100100000101000000000000001
10100100101010100010010010000101000000000000001
10100100101010100010010011000101000000000000001
10100100101010100010010001000101000000000000001
10100100101010100010010000000101000000000000001
101001001010101000100100110000101000000000000001
10100100101010100010010010000101000000000000001
101001001010101000100100001000101000000000000001
10100100101010100010010000100101000000000000001
10100100101010100010010000000101000000000000001
1P0000000C00C00000000000000000000000000000000C1
11111111111111111111111111111111111111111111111