1111111111111
1C100000000C1
1C10000000111
1P0011110C001
11C011E000001
1111111111111