1111111111111
1C00000000001
1C00000000001
1C00000000001
1C00000000001
1C00000000001
1P0001110C001
10C011E000001
1111111111111